注目を集める	が	サポートベクターマシンが 
学習を行う	に	を	元に 経験を 
進化を見せる	て	て	において	は	加えて 活躍している 生成技術において 敵対的生成ネットワークは 
機械式計算機をする	は	ブレーズ・パスカルは 
開発を行う	は	エイダ・ラブレスは 
プログラミング言語をする	は	彼はまた 
プログラミング言語をする	は	アラン・カルメラウアーは 
専用コンピュータ・をする	に	は	1992年に IBMは 
投資全額を上回る	が	コストが 
意味付けをする	から	に対して	ここから 非構造化データに対して 
知的処理を行う	に	に	により	Webに 同年に ティム・バーナーズ＝リーにより 
意味をする	に	データに 
知的処理を行う	て	に	付加して コンピュータに 
研究を進める	て	費やして 
運転をする	に	元に 
特許をする	が	まで	日本が 2018年までに 
運転をする	て	に	基づいて 柔軟に 
注目を集める	から	は	ことから ファジィは 
知的制御を用いる	て	も	受けて 他社も 
精度改善を果たす	が	で	に	チームが 画像処理コンテストで 2012年に 
研究を続ける	が	て	ジェフ・ホーキンスが 向けて 
行動型システムを用いる	て	は	は	登場している これは ものではなく 
ワンショット学習をする	が	データが 
記号接地問題問題をする	に	8月には 
注目を集める	に	急速に 
投資を行う	で	に	民間企業主導で 全世界的に 
探索を行う	で	無報酬で 
共同研究を始める	とも	は	マックスプランク研究所とも Googleは 
研究を行う	て	て	始めており 行っている 
研究開発をする	で	で	中国では 官民一体で 
研究開発をする	で	日本で 
投資をする	は	まで	韓国は 2022年までに 
反乱を起こす	て	に対して	於いて 人間に対して 
法的手続きを経る	を	ウイグル族を 
ファジィ制御をする	は	AIプログラムは 
判断を介す	から	観点から 
禁止を求める	が	に	ヒューマン・ライツ・ウォッチが 4月には 
追及を受ける	て	で	で	と	とともに	暴露されており 公聴会では 整合性で 拒否すると とともに 
共同研究をする	が	Microsoftが 
監視国家をする	が	によって	中国が AIによって 
解任をする	て	は	含まれており Google社員らは 
解散をする	が	で	は	倫理委員会が 理由で Googleは 
霊的存在を見いだす	に	ものに 
話をする	は	哲学者は 
議論を行う	まで	これまで 
